1111111111111
10000000000C1
1110011111001
1P00000000E11
1111111111111