1111111111111
10C0000C000C1
1110011111001
1P000C00000E1
1111111111111