111111111111111
10C0000C000C111
1110C1111C001C1
1P000C00010E1C1
110111111111001
10C00111C10C011
1111000C0001111
111111111111111