1111111111111
10000000000C1
1110011111001
1P000000000E1
1111111111111