111111111111111
10C0000C000C111
1110C1111C001C1
1P000C0001001C1
110111111111001
10C00111C10CC11
1111000C0001E11
111111111111111