1111111111111
10000000000C1
1110011111001
1P0000000E011
1111111111111