1111111111111
100100001C0C1
1000011111001
1P0110E000011
1111111111111