1111111111111
100000000C0C1
1000011111001
1P0110E000011
1111111111111