111111111111111
10C0000C000C111
1110C1111C001C1
1P000C00010E1C1
110111111111001
10C00111C10C011
1110000C0001111
100011111111111
100C00000C0C001
111111001111111
10000C000111111
111111111111111