111111111111111111
100CP0000000000001
10E010001111100001
100010001000000001
100C1C001000000001
10001000100C000001
100011111111100001
1000000C1000100001
10000C0010C01C0001
100000001000100001
1000111110C0100001
10000C000000000001
111111111111111111